XXXXXXXXXXXXXX
X&&..X.....XXX
X&&..X.*..*..X
X&&..X*XXXX..X
X&&....t.XX..X
X&&..X.X..*.XX
XXXXXX.XX*.*.X
XXX.*..*.*.*.X
XXX....X.....X
XXXXXXXXXXXXXX