XXXXXXXXXXXXXXXXX
XXXXXXXXX.....tXX
XXXXXXXXX.*X*.XXX
XXXXXXXXX.*..*XXX
XXXXXXXXXX*.*.XXX
XXXXXXXXX.*.X.XXX
X&&&&..XX.*..*..X
XX&&&....*..*...X
X&&&&..XXXXXXXXXX
XXXXXXXXXXXXXXXXX
