XXXXXXXXXXXXXXXXXXXXXX
XXXXXXXXXXXXXXX..&&&&X
XXXXXXXXXXXXXXX..&&&&X
XXXX....X..*.*...&&&&X
XXXX.***X*..*.X..&&&&X
XXXX..*.....*.X..&&&&X
XXXX.**.X*.*.*XXXXXXXX
XXXX..*.X.....XXXXXXXX
X...X.XXXXXXXXXXXXXXXX
X....*..XXXXXXXXXXXXXX
X.**X**.tXXXXXXXXXXXXX
X...X...XXXXXXXXXXXXXX
XXXXXXXXXXXXXXXXXXXXXX