XXXXXXXXXXXXXXXXX
XXXXXXXXX...XXXXX
XXXXXXXXX.X*XX..X
XXXXXXXXX.....*.X
XXXXXXXXX.XXX...X
X&&&&..XX.*..*XXX
X&&&&....*.**.XXX
X&&&&..XX*..*.tXX
XXXXXXXXX..*..XXX
XXXXXXXXX.*.*..XX
XXXXXXXXXXX.XX.XX
XXXXXXXXXXX....XX
XXXXXXXXXXXXXXXXX
