XXXXXXXXXXXX
X&&..XXXXtXX
X&&..XXX...X
X&&.....**.X
X&&..X.X.*.X
X&&XXX.X.*.X
XXXX.*.X*..X
XXXX..*X.*.X
XXXX.*..*..X
XXXX..XX...X
XXXXXXXXXXXX