XXXXXXXXXXXXX
XXXXXXXX...XX
XX.X.tXX.**.X
X....*......X
X..*..XXX...X
XXX.XXXXX*XXX
X.*..XXX.&&XX
X.*.*.*.&&&XX
X....XXX&&&XX
X.**.XXX&&&XX
X..XXXXXXXXXX
XXXXXXXXXXXXX