XXXXXXXXXXXXXXXX
XXX..XXXXXXXXXXX
XXX....*...*.*.X
XXX.*X.*.X..*..X
XXX..*.*..X....X
XXX.*X.X..XXXX.X
XtX*.*.*..XX...X
X....*.X*X...X.X
XX..*....*.*.*.X
XXXXX..XXXXXXXXX
XXXXX..XXXXXXXXX
XXX......XXXXXXX
XXX......XXXXXXX
XXX&&&&&&XXXXXXX
XXX&&&&&&XXXXXXX
XXX&&&&&&XXXXXXX
XXXXXXXXXXXXXXXX