XXXXXXXXXXXXXXXXX
XXXXXXXXXXX..&&&X
XXXXXXXXXXX..&&&X
XXXXXXX......&&&X
XXXXXXX..XX..&&&X
XXXXXXXX.XX..&&&X
XXXXXXXX.XXXXXXXX
XXXXXX.***.XXXXXX
XXXXXX..*.*.XXXXX
XX...X*.*...X...X
Xt.*..*....*..*.X
XXXXXX..*.*.XXXXX
XXXXXX.*....XXXXX
XXXXXXXXX.XXXXXXX
XXXXXXXXX..XXXXXX
XXXXXXXXX..XXXXXX
XXXXXXXXX..XXXXXX
XXXXXXXXXXXXXXXXX